OOOOOOOOO
O...O..EO
OO..O...O
O.C....OO
O.E....DO
O.....EOO
OEC.....O
O.....OCO
OOOOOOOOO