OOOOOOOOO
OG.....EO
O...EC..O
OD..E...O
OO.O.C..O
O....E..O
O.C..E..O
OG....EOO
OOOOOOOOO