OOOOOOOOO
OO.CO...O
O...O.E.O
O..O....O
O....E..O
OC....OOO
OD.E...DO
O.....EOO
OOOOOOOOO