OOOOOOOOO
O....C..O
OOE.....O
O......DO
OD....ECO
O.E.....O
O...O...O
O...O...O
OOOOOOOOO