OOOOOOOOO
O..CO...O
O..OOE..O
O..O....O
O.......O
OC....OOO
O......DO
O..E...OO
OOOOOOOOO