OOOOOOOOO
O.E....CO
O....OOOO
O...E..DO
OC......O
OOOO....O
OD.....MO
O...E...O
OOOOOOOOO