OOOOOOOOO
OCCO....O
OE.O....O
O....E..O
OD......O
OOOO.E..O
OC.O....O
O....G..O
OOOOOOOOO