OOOOOOOOO
O.O..E..O
O.E....OO
O...E...O
OD....O.O
O.O....CO
OCE....DO
OE..O...O
OOOOOOOOO