OOOOOOOOO
O....C..O
OOE.....O
O.......O
OD....EDO
O.......O
O...O...O
O...O...O
OOOOOOOOO