OOOOOOOOO
O..CO...O
O..OOE..O
O.......O
OD......O
OC...EOOO
O.......O
O..E...GO
OOOOOOOOO