OOOOOOOOO
OC.....MO
OOO.....O
O...E...O
O......DO
O.......O
OE..C...O
O.....O.O
OOOOOOOOO